ay,android,ios,windows,linux,unknown,toplam
ocak,1528,320,108,2,0,1958
subat,1861,360,88,2,0,2311
mart,2196,463,171,6,1,2837
nisan,1882,385,126,2,0,2395
mayis,1813,358,87,4,0,2262
haziran,2692,565,176,1,1,3435
temmuz,3204,744,141,2,0,4091
agustos,2469,685,122,0,1,3277
eylul,3160,600,112,2,0,3874
ekim,4149,805,689,1,0,5644
kasim,4087,738,854,0,1,5680
aralik,3871,691,668,2,0,5232
ocak,3568,637,573,1,0,4779
subat,3331,526,805,2,0,4664
